....................
....................
.111......../.......
..1111....../11111..
..../......./.......
..../......./.......
..../../111./.......
..../../..../.......
..../../..../.......
......//..../.......
....11//1111/.......
......//..../.......
....../.............
...@../.............
11111111111111111111
# 15 lines, 20 columns
# make comments with '#'
# 1 is a ground block, / is a vine
# @ is the player starting point
# + will be the coins
# anything else is invalid and ignored