..........+.........
......./1111........
......./............
......./............
......./$+.$./......
.$.+$../11111/......
.111111/....1/......
.......//...1/......
......///..+1/......
.....././1111/......
....+./.....1/......
....11/1....1/......
....../.....1/......
....../.@...1/....D.
11111111111111111111