.....+..............
....1111/1........+.
......../....../1111
......../....../....
......../..+.../....
.../1111/1111../....
.../..../.....+/....
.../..../..../11....
.../..../..../......
.../..../.D../......
.../....11111/11....
.../........./......
.+./........./......
.1111......../.@....
11111111111111111111