....................
....................
...+................
.1111....+.../......
....1/1111111/......
...../......./......
....//.......//.....
..../........./.....
..../.$+..$.../.....
...1/111111.../.D...
..../......./11111..
..../......./.......
..../......./.......
..@./......./....+..
1111111....111111111