1....+..............
1...1111/1........+.
1......./....../1111
1......./....../....
1......./..+.../....
1../1111/1111../....
1../..../.....+/....
.../..../..../11....
.../..../..../......
.../..../..../......
.../....11111/11....
.../........./......
.+./........./......
.1111......D./.@....
11111111111111111111