....................
..................+.
.....//////....11/11
....+/..$^..$...//..
.1/111..11111/..//..
../........../../...
../........../../...
../..$+.$..../+./...
..11/1111...1111/1..
..../..........//...
..../.........///...
..../.......+././...
..../......1111./...
.@../.........../.D.
111111.........11111